  .-.---------------------------------.-.
  ((o))                                   )
   \U/_______          _____         ____/
     |                                  |
     |                                  |
     |                                  |
     |                                  |
     |                                  |
     |                                  |
     |                                  |
     |                                  |
     |                                  |
     |                                  |
     |                                  |
     |____    _______    __  ____    ___|
    /A\                                  \
   ((o))                                  )
    '-'----------------------------------'